    bardus - slow, dull
    brevis - short, brief
    comminus - in close combat
    electus - chosen
    extremus - last, extreme
    gravatus - sick, ill
    gravis - heavy, serious, important, grievous
    hodiernus - of today
    honorabilis - respectful
    idoneus - proper, fitting, capable
    ignarus - ignorant
    ignavus - lazy, inert, sluggish, a coward
    ignotus - unknown, obscure, ignorant
    immortalis - immortal
    incorruptus - genuine, pure
    liquidus - fluid, liquid, flowing
    prudens - prudent, wise
    regius - royal, regal
    rusticus - rustic, rural
    salvus - safe, sound
    serius - serious, grave
    simplex - simple
    tersus - clean, neat
    tutis - protected, safe, secure
    vetus - old
    bene - well
    benigne - kindly, generously
    cras - tomorrow
    deinde - next, thereafter
    eminus - from a distance
    graviter - seriously
    heri - yesterday
    hodie - today
    pariter - equally, as well
    quoque - also, too
    quotiens - often
    semper - always, ever
    serio - seriously
    velociter - quickly, swiftly
    vero - in truth, indeed, to be sure
    abbas - father
    abbatia - monastery
    basium - kiss
    benevolentia - benevolence, good will
    caelum - sky, heaven
    calamitas - calamity, disaster
    campana - bell
    caput - head, summit, top
    carmen - poem, song
    commissum - undertaking, that which is entrusted
    delectatio - delight, enjoyment
    dux - leader, general, commander, duke
    ecclesia - church
    episcopus - bishop
    epistula - letter, message
    eventus - consequence, result, experience
    famulus - servant
    fides - promise, engagement, word of honor
    flamma - flame, fire
    frigus - cold, winter, indolence
    gaudium - joy, happiness, delight
    gloria - fame, glory
    gravitas - weight, importance
    hereditas - inheritance
    hora - hour, time
    hypocrita - hypocrite
    ictus - blow, bite, thrust
    ignis - fire
    inceptum - beginning, attempt
    juvenis - youth, young man
    labor - labor, work
    limen - threshold
    lingua - language, speech
    linteum - linen, napkin
    ludio - actor, player
    ludus - game, sport
    lues - pestilence, calamity
    lux - light
    luxuria - luxury, opulence
    mane - morning
    mare - sea
    maritus - husband
    mater - mother
    materia - material, matter
    matertera - maternal aunt
    matrimonium - marriage
    memoria - memory, remembrance, recall
    missa - holy mass
    monachus - monk
    mundus - world, universe
    natio - nation, people
    natura - nature
    nefas - wrong, sin
    nihilum - nothing
    novitas - newness, novelty
    opera - work, labor
    oratio - speech, oration
    palma - palm
    pater - father
    pax - peace
    placitum - judgment, case, plea
    plorator - lamenter
    ploratus - weeping, lamenting
    pluvia - rain, shower
    pluma - feather, pen
    pulpa - flesh
    rectum - virtue, right
    sacrificum - sacrifice
    sapientia - wisdom
    sermo - discussion, talk, conversation
    servitus - slavery
    spes - hope
    synagoga - synagogue
    tabellae - letter, document
    tempestas - storm, weather
    umbra - shade, shadow
    uxor - wife, spouse
    vestigium - footstep, trace, mark
    vita - life
    voluptas - pleasure
    xiphias - swordfish

